rows=5
cols=5
1,0,3,0,0
0,0,3,3,3
0,3,3,0,3
0,0,0,0,3
0,0,3,0,2